@@@...@@.
....@....
@@@.@.@@@
..@.@..@.
....@@...